。	｡
「	｢
」	｣
、	､
・	･
ヲ	ｦ
ヲ゛	ｦﾞ
ァ	ｧ
ィ	ｨ
ゥ	ｩ
ェ	ｪ
ォ	ｫ
ャ	ｬ
ュ	ｭ
ョ	ｮ
ッ	ｯ
ー	ｰ
ア	ｱ
イ	ｲ
ウ	ｳ
ヴ	ｳﾞ
エ	ｴ
オ	ｵ
カ	ｶ
キ	ｷ
ク	ｸ
ケ	ｹ
コ	ｺ
ガ	ｶﾞ
ギ	ｷﾞ
グ	ｸﾞ
ゲ	ｹﾞ
ゴ	ｺﾞ
サ	ｻ
シ	ｼ
ス	ｽ
セ	ｾ
ソ	ｿ
ザ	ｻﾞ
ジ	ｼﾞ
ズ	ｽﾞ
ゼ	ｾﾞ
ゾ	ｿﾞ
タ	ﾀ
チ	ﾁ
ツ	ﾂ
テ	ﾃ
ト	ﾄ
ダ	ﾀﾞ
ヂ	ﾁﾞ
ヅ	ﾂﾞ
デ	ﾃﾞ
ド	ﾄﾞ
ナ	ﾅ
ニ	ﾆ
ヌ	ﾇ
ネ	ﾈ
ノ	ﾉ
ハ	ﾊ
ヒ	ﾋ
フ	ﾌ
ヘ	ﾍ
ホ	ﾎ
バ	ﾊﾞ
ビ	ﾋﾞ
ブ	ﾌﾞ
ベ	ﾍﾞ
ボ	ﾎﾞ
パ	ﾊﾟ
ピ	ﾋﾟ
プ	ﾌﾟ
ペ	ﾍﾟ
ポ	ﾎﾟ
マ	ﾏ
ミ	ﾐ
ム	ﾑ
メ	ﾒ
モ	ﾓ
ヤ	ﾔ
ユ	ﾕ
ヨ	ﾖ
ラ	ﾗ
リ	ﾘ
ル	ﾙ
レ	ﾚ
ロ	ﾛ
ワ	ﾜ
ワ゛	ﾜﾞ
ン	ﾝ
゛	ﾞ
゜	ﾟ
